-1, -1, -1, -1, -1, -1, -1, -1, -1, -1, -1, -1, -1, -1, -1, -1, -1, -1, -1, -1, -1, -1 -1 -1
-1, -1, -1, -1, -1, -1, -1, -1, -1, -1, -1, -1, -1, -1, -1, -1, -1, -1, -1, -1, -1, -1 -1 -1
-1, -1, -1, -1, -1, -1, -1,  0,  0,  0,  0,  0,  0,  0,  5, -1, -1, -1, -1, -1, -1, -1 -1 -1
-1, -1, -1, -1, -1, -1,  5,  0, -1, -1, -1, -1, -1,  0, -1, -1, -1, -1, -1, -1, -1, -1 -1 -1
-1, -1, -1, -1, -1,  0,  0,  0, -1, -1, -1, -1, -1,  0, -1, -1, -1, -1, -1, -1, -1, -1 -1 -1
-1, -1, -1, -1, -1,  0, -1, -1, -1, -1, -1, -1, -1,  0, -1, -1,  5, -1,  2,  2,  2, -1 -1 -1
-1, -1, -1, -1, -1,  0, -1, -1, -1, -1, -1, -1, -1,  0,  0,  0,  0,  0,  0,  3,  2, -1 -1 -1
-1, -1, -1, -1,  5,  0, -1, -1, -1, -1, -1, -1, -1, -1, -1, -1, -1, -1,  2,  2,  2, -1 -1 -1
 0,  0,  0, -1, -1,  0, -1, -1, -1, -1, -1, -1, -1, -1, -1, -1, -1, -1, -1, -1, -1, -1 -1 -1
-1, -1,  0, -1, -1,  0, -1, -1, -1, -1, -1, -1, -1, -1, -1, -1, -1, -1, -1, -1, -1, -1 -1 -1
-1, -1,  0,  0,  0,  0, -1, -1, -1, -1, -1, -1, -1, -1, -1, -1, -1, -1, -1, -1, -1, -1 -1 -1
-1, -1, -1, -1, -1, -1, -1, -1, -1, -1, -1, -1, -1, -1, -1, -1, -1, -1, -1, -1, -1, -1 -1 -1
-1, -1, -1, -1, -1, -1, -1, -1, -1, -1, -1, -1, -1, -1, -1, -1, -1, -1, -1, -1, -1, -1 -1 -1